BD51155553
AF96AFFFBA
AFC7857F86
AFFFAFFFC3
A93FAFD53A
C6AFAFFFC6
9503C53953
C56C5546D6

0,0
0,6
SSSSSENESSWW
